WWWWWWWWWWWWWWWWWWW
WOEEEEEEEEEEEEEEEOW
WEEEEEEEE1EEEEEEEEW
WEEEEEEE234EEEEEEEW
WREEEEEEEEEEEEEEEBW
WWWWWWWWWWWWWWWWWWW
WEEEEEEEEEEEEEEEEEW
WEEWWWWWEEEWWWWWEEW
WEEWEEEEEEEEEWEEEEW
WEEWEEEEEEEEEWEEEEW
WEEWWWWWEEEWWWWWEEW
WEEEEEEEEEEEEEEEEEW
WEEEEEEEEEEEEEEEEEW
WEEEWWWEEEEWWWWWEEW
WEEWEEEWEEEWEEEWEEW
WEEWWWWWEEEWEEEWEEW
WEEWEEEWEEEWWWWWEEW
WEEEEEEEEEEEEEEEEEW
WEEEEEEEEEEEEEEEEEW
WEEEEEEEESEEEEEEEEW
WWWWWWWWWWWWWWWWWWW