EEEWWWWWWWWWWWWWEEE
EEEWOOOOOOOOOOOWEEE
WWWWWOOOWWWOOOWWWWW
WOOOOOOWWWWWOOOOOOW
WPOWOWOWOOOWOWOWOPW
WOOWOWOOOOOOOWOWOOW
WOOOOOEEEWEEEOOOOOW
WOWWWWEEWWWEEWWWWOW
WOWOOOEEEEEEEOOOWOW
WOOOWWEWEWEWEWWOOOW
WOWORWEW324WEWBOWOW
WOWWWWEWW1WWEWWWWOW
WOOOWWOOWEWOOWWOOOW
WOWOOWEOOOOOEWOOWOW
WOOOOOEWWOWWEOOOOOW
WOWWWOEEWWWEEOWWWOW
WOOWWOEEESEEEOWWOOW
WPOOWOWWWWWWWOWOOPW
WWWOOOWOOOOOWOOOWWW
EEWWOOOOWWWOOOOWWEE
EEEWWWWWWEWWWWWWEEE