WWWWWWWWWWWWWWWWWWW
WOOBWPOWOOOWOPWROOW
WOWWWWOWOWOWOWWWWOW
WOWOOOOOOWOOOOOOWOW
WOOOWWWOWWWOWWWOOOW
WWWOOOWOWWWOWOOOWWW
WOOOWOOEEEEEOOWOOOW
WOWOWWOWWEWWOWWOWOW
WOWOOOEEEEEEEOOOWOW
WOWWOWEWW1WWEWOWWOW
WOOOOEEE324EEEOOOOW
WOWOWWEWWWWWEWWOWOW
WOWOOEEEEEEEEEOOWOW
WOWWOWWEEWEEWWOWWOW
WPOOOWWEWWWEWWOOOPW
WWOWOOOOOSOOOOOWOWW
WOOWOWWWOWOWWWOWOOW
WOWWOWOOOWOOOWOWWOW
WOOOOOOWWWWWOOOOOOW
WOWWOWOOOOOOOWOWWOW
WWWWWWWWWWWWWWWWWWW