WWWWWWWWWWWWWWWWWWW
WEEEEEEEEWEEEEEEEEW
WEWWEWWWEWEWWWEWWEW
WEEEEEEEEEEEEEEEEEW
WEWWEWEWWWWWEWEWWEW
WEEEEWEEEWEEEWEEEEW
WWWWEWWWEWEWWWEWWWW
EEEWEWEEEEEEEWEWEEE
WWWWEWEWWEWWEWEWWWW
WEEEEEEWEEEWEEEEEEW
WWWWEWEWWWWWEWEWWWW
EEEWEWEEEEEEEWEWEEE
WWWWEWEWWWWWEWEWWWW
WEEEEEEEEWEEEEEEEEW
WEWWEWWWEWEWWWEWWEW
WEEWEEEEEPEEEEEWEEW
WWEWEWEWWWWWEWEWEWW
WEEEEWEEEWEEEWEEEEW
WEWWWWWWEWEWWWWWWEW
WEEEEEEEEEEEEEEEEEW
WWWWWWWWWWWWWWWWWWW