WWWWWWWWWWWWWWWWWWW
WOOOOOOOOWOOOOOOOOW
WOWWOWWWOWOWWWOWWOW
WOOOOOOOOOOOOOOOOOW
WOWWOWOWWWWWOWOWWOW
WOOOOWOOOWOOOWOOOOW
WWWWOWWWOWOWWWOWWWW
EEEWOWEEEEEEEWOWEEE
WWWWOWEWW1WWEWOWWWW
WEEEOEEWEEEWEEOEEEW
WWWWOWEWWWWWEWOWWWW
EEEWOWEEEEEEEWOWEEE
WWWWOWOWWWWWOWOWWWW
WOOOOOOOOWOOOOOOOOW
WOWWOWWWOWOWWWOWWOW
WOOWOOOOOPOOOOOWOOW
WWOWOWOWWWWWOWOWOWW
WOOOOWOOOWOOOWOOOOW
WOWWWWWWOWOWWWWWWOW
WOOOOOOOOOOOOOOOOOW
WWWWWWWWWWWWWWWWWWW