WWWWWWWWWWWWWWWWWWW
WOOOOOOOOWOOOWOOOPW
WOWOWWWWOWOWOWOWWOW
WOWOWWWWOOOWOOOOOOW
WOOOOOOOOOOWWOWOWWW
WWWWOOWWWWOWROOOWWW
WOOOOOWOOWOWWOWOOOW
WWWWOOOOOOOOOOWOWOW
EWWWOOWOWWWWWOOOOWE
EWOWOWWOWWWOOOWWOWE
EW21OWPOOOWPWOOOSWE
EWOWOWWOWWWOOOWWOWE
EWWWOOWOWWWWWOOOOWE
WWWWOOOOOOOWWWWOWOW
WOOOOOOOOWOOOOOOOOW
WOOOOOBOOWWWWOOWWWW
WOOOOOOOOWWWOOOOOOW
WOOOOOOOOOOWOWWOWOW
WOOOOOOOOOOWOWWOWOW
WPOOOOOOOOOOOOOOOOW
WWWWWWWWWWWWWWWWWWW